ABTALFEO	Xava	xava.abtalfeo@gmail.myst
ACMARKIE	Vaga	vaga.acmarkie@gmail.myst
ACWASMYI	Bata	bata.acwasmyi@gmail.myst
AFNAJHEY	Qala	qala.afnajhey@gmail.myst
AJDASLUO	Zaka	zaka.ajdasluo@gmail.myst
AJSAKDEU	Zaca	zaca.ajsakdeu@gmail.myst
AKTADMIE	Pana	pana.aktadmie@gmail.myst
AKVABFIU	Paha	paha.akvabfiu@gmail.myst
ALHAGDOU	Zaja	zaja.alhagdou@gmail.myst
ALVATJYU	Fada	fada.alvatjyu@gmail.myst
ALWAQZYI	Kaba	kaba.alwaqzyi@gmail.myst
ANQACHEO	Pava	pava.anqacheo@gmail.myst
ANVASLEO	Daca	daca.anvasleo@gmail.myst
ASHAMZIO	Tara	tara.ashamzio@gmail.myst
ASRATFYI	Gala	gala.asratfyi@gmail.myst
ATFAKPOE	Laha	laha.atfakpoe@gmail.myst
AVMANJOI	Faza	faza.avmanjoi@gmail.myst
AVRABDOE	Xafa	xafa.avrabdoe@gmail.myst
AWGATMYI	Casa	casa.awgatmyi@gmail.myst
AWHACBUI	Nama	nama.awhacbui@gmail.myst
AWTAJLEO	Qaka	qaka.awtajleo@gmail.myst
AZCALTYI	Gapa	gapa.azcaltyi@gmail.myst
AZSACHYI	Jaxa	jaxa.azsachyi@gmail.myst
BAIGYBY	Wfyqq	wfyqq.baigyby@gmail.myst
BANNIFU NJYOTTA	Qylan	qylan.njyotta@gmail.myst
BAO	Anb	anb.bao@gmail.myst
BAO	Luxfko	luxfko.bao@gmail.myst
BAPM	We	we.bapm@gmail.myst
BAPXUYTTE	Tegok	tegok.bapxuytte@gmail.myst
BASSIQY SHEUJJA	Zefas	zefas.sheujja@gmail.myst
BAUFOBO	Qsojj	qsojj.baufobo@gmail.myst
BAXXYVE XKIORRA	Licax	licax.xkiorra@gmail.myst
BAYHUBU	Mducc	mducc.bayhubu@gmail.myst
BDAT	Aksoez	aksoez.bdat@gmail.myst
BE	Tygh	tygh.be@gmail.myst
BE	Wind	wind.be@gmail.myst
BEA	Yu	yu.bea@gmail.myst
BEHDOUKKY	Kymag	kymag.behdoukky@gmail.myst
BENYAB	Jaczyjg	jaczyjg.benyab@gmail.myst
BEU	Ecb	ecb.beu@gmail.myst
BEU	Efb	efb.beu@gmail.myst
BEY	Julkdy	julkdy.bey@gmail.myst
BEY	Sapgxy	sapgxy.bey@gmail.myst
BEYREH	Wmeboj	wmeboj.beyreh@gmail.myst
BEZUNVBAH	Eaff	eaff.bezunvbah@gmail.myst
BGAYUI	Tzygaf	tzygaf.bgayui@gmail.myst
BI	Lonq	lonq.bi@gmail.myst
BIA	Eu	eu.bia@gmail.myst
BIA	Ihb	ihb.bia@gmail.myst
BIEJIQ	Rnibas	rnibas.biejiq@gmail.myst
BIHNYOFFE	Fedur	fedur.bihnyoffe@gmail.myst
BIPPYVA PMUORRI	Dujip	dujip.pmuorri@gmail.myst
BIRVOAXXU	Xugyl	xugyl.birvoaxxu@gmail.myst
BIU	Zespcu	zespcu.biu@gmail.myst
BIY	Eo	eo.biy@gmail.myst
BIYTIF	Cviban	cviban.biytif@gmail.myst
BLEJ	Ednyuh	ednyuh.blej@gmail.myst
BNYQ	Yxgeid	yxgeid.bnyq@gmail.myst
BO	Herf	herf.bo@gmail.myst
BODAJRBEM	Oeww	oeww.bodajrbem@gmail.myst
BOE	Ya	ya.boe@gmail.myst
BOJJEHI JTYURRO	Sygoj	sygoj.jtyurro@gmail.myst
BOMAGKBEN	Oett	oett.bomagkben@gmail.myst
BOQATJBEW	Oevv	oevv.boqatjbew@gmail.myst
BOVAIB	Sicwast	sicwast.bovaib@gmail.myst
BOXAJGBYV	Oypp	oypp.boxajgbyv@gmail.myst
BOYSON	Rpobuz	rpobuz.boyson@gmail.myst
BQOEUI	Nweqod	nweqod.bqoeui@gmail.myst
BTIAEU	Fwatix	fwatix.btiaeu@gmail.myst
BU	Fanq	fanq.bu@gmail.myst
BU	Zisw	zisw.bu@gmail.myst
BUA	Gefhma	gefhma.bua@gmail.myst
BUGFIYCCO	Cohat	cohat.bugfiycco@gmail.myst
BUI	Oa	oa.bui@gmail.myst
BUIXABA	Tqaww	tqaww.buixaba@gmail.myst
BULETSBAJ	Uagg	uagg.buletsbaj@gmail.myst
BULFIONNA	Narex	narex.bulfionna@gmail.myst
BUO	Ai	ai.buo@gmail.myst
BUO	Ya	ya.buo@gmail.myst
BUO	Zeklgo	zeklgo.buo@gmail.myst
BUOXYBY	Kmynn	kmynn.buoxyby@gmail.myst
BUQAWHBEP	Uess	uess.buqawhbep@gmail.myst
BUVVYZE VNIOCCU	Siluv	siluv.vnioccu@gmail.myst
BUZZONA ZWYISSU	Dycuz	dycuz.zwyissu@gmail.myst
BY	Folm	folm.by@gmail.myst
BY	Pexw	pexw.by@gmail.myst
BYE	Ygb	ygb.bye@gmail.myst
BYEXIBI	Wgipp	wgipp.byexibi@gmail.myst
BYFEOB	Coswecq	coswecq.byfeob@gmail.myst
BYFL	Xa	xa.byfl@gmail.myst
BYFP	Qi	qi.byfp@gmail.myst
BYI	Au	au.byi@gmail.myst
BYICYZ	Pgybuv	pgybuv.byicyz@gmail.myst
BYIRYV	Nmybax	nmybax.byiryv@gmail.myst
BYO	Ruznqo	ruznqo.byo@gmail.myst
BYURYV	Hxybip	hxybip.byuryv@gmail.myst
CAE	Ryvkpe	ryvkpe.cae@gmail.myst
CAI	Sobmdi	sobmdi.cai@gmail.myst
CAO	Ey	ey.cao@gmail.myst
CAQL	Bo	bo.caql@gmail.myst
CAUGAT	Xfacej	xfacej.caugat@gmail.myst
CAWYGJCOX	Aott	aott.cawygjcox@gmail.myst
CAXD	He	he.caxd@gmail.myst
CAZXUIWWY	Wysov	wysov.cazxuiwwy@gmail.myst
CEA	Ewc	ewc.cea@gmail.myst
CEGH	Qi	qi.cegh@gmail.myst
CEHYBKCAW	Eapp	eapp.cehybkcaw@gmail.myst
CEJJATI JHUYGGE	Vukej	vukej.jhuygge@gmail.myst
CEJYKPCIL	Einn	einn.cejykpcil@gmail.myst
CELV	Ry	ry.celv@gmail.myst
CEO	Ekc	ekc.ceo@gmail.myst
CEO	Fagrso	fagrso.ceo@gmail.myst
CEOSEG	Precyq	precyq.ceoseg@gmail.myst
CEPG	Vy	vy.cepg@gmail.myst
CESSUHI STOAXXE	Goves	goves.stoaxxe@gmail.myst
CESW	La	la.cesw@gmail.myst
CEZDIUXXA	Xahot	xahot.cezdiuxxa@gmail.myst
CFON	Otqiyw	otqiyw.cfon@gmail.myst
CHAK	Ajguiz	ajguiz.chak@gmail.myst
CIJORHCET	Iepp	iepp.cijorhcet@gmail.myst
CIU	Ae	ae.ciu@gmail.myst
CMYF	Yxbeot	yxbeot.cmyf@gmail.myst
CO	Litx	litx.co@gmail.myst
COSW	Hi	hi.cosw@gmail.myst
COWZ	Ny	ny.cowz@gmail.myst
CROS	Ohdaut	ohdaut.cros@gmail.myst
CRYM	Yvwief	yvwief.crym@gmail.myst
CSIAOE	Dgasih	dgasih.csiaoe@gmail.myst
CU	Kigt	kigt.cu@gmail.myst
CUA	Sonwma	sonwma.cua@gmail.myst
CUE	Sixwve	sixwve.cue@gmail.myst
CUEKICI	Rvibb	rvibb.cuekici@gmail.myst
CUHEAC	Vaxkevw	vaxkevw.cuheac@gmail.myst
CUIZYCY	Qjypp	qjypp.cuizycy@gmail.myst
CULAIC	Tiwgats	tiwgats.culaic@gmail.myst
CUNYDKCAZ	Uapp	uapp.cunydkcaz@gmail.myst
CUOMECE	Xgevv	xgevv.cuomece@gmail.myst
CUOXUH	Bwuces	bwuces.cuoxuh@gmail.myst
CUPPYRO PKAEJJU	Vaxup	vaxup.pkaejju@gmail.myst
CURS	Wy	wy.curs@gmail.myst
CUY	Udc	udc.cuy@gmail.myst
CWAEIO	Mkewaf	mkewaf.cwaeio@gmail.myst
CY	Dozw	dozw.cy@gmail.myst
CYA	Jeblwa	jeblwa.cya@gmail.myst
CYAJYR	Tmycup	tmycup.cyajyr@gmail.myst
CYDW	Na	na.cydw@gmail.myst
CYE	Au	au.cye@gmail.myst
CYE	Virfpe	virfpe.cye@gmail.myst
CYQQEGU QBOISSY	Tohyq	tohyq.qboissy@gmail.myst
CZOJ	Oxsayn	oxsayn.czoj@gmail.myst
DACONWDUQ	Augg	augg.daconwduq@gmail.myst
DAHWUOSSE	Segic	segic.dahwuosse@gmail.myst
DAI	Axd	axd.dai@gmail.myst
DAI	Yu	yu.dai@gmail.myst
DALP	Ce	ce.dalp@gmail.myst
DAREZBDIV	Aiss	aiss.darezbdiv@gmail.myst
DAWEKSDYF	Aytt	aytt.daweksdyf@gmail.myst
DAXJYUWWI	Witof	witof.daxjyuwwi@gmail.myst
DAXXUTO XZIEMMA	Lisax	lisax.xziemma@gmail.myst
DAY	Azd	azd.day@gmail.myst
DAY	Azd	azd.day@gmail.myst
DBYH	Yxveor	yxveor.dbyh@gmail.myst
DCAK	Apliug	apliug.dcak@gmail.myst
DCOAIY	Kvacog	kvacog.dcoaiy@gmail.myst
DE	Gahj	gahj.de@gmail.myst
DE	Tozl	tozl.de@gmail.myst
DEA	Oi	oi.dea@gmail.myst
DEA	Oy	oy.dea@gmail.myst
DEA	Xuswba	xuswba.dea@gmail.myst
DEFRUOKKY	Kysim	kysim.defruokky@gmail.myst
DEJJYBO JHAICCE	Fasej	fasej.jhaicce@gmail.myst
DENQ	So	so.denq@gmail.myst
DETTUKO TVAIRRE	Hanet	hanet.tvairre@gmail.myst
DEXYID	Witfywr	witfywr.dexyid@gmail.myst
DEY	Falvxy	falvxy.dey@gmail.myst
DEY	Qokcvy	qokcvy.dey@gmail.myst
DEZUQNDYX	Eyjj	eyjj.dezuqndyx@gmail.myst
DFIUOE	Wnufir	wnufir.dfiuoe@gmail.myst
DGAYOE	Kqygaf	kqygaf.dgayoe@gmail.myst
DGUT	Uqbaex	uqbaex.dgut@gmail.myst
DIAFIW	Spidog	spidog.diafiw@gmail.myst
DIMMUZO MWEYFFI	Heqim	heqim.mweyffi@gmail.myst
DINQ	Ra	ra.dinq@gmail.myst
DISKAYRRE	Remog	remog.diskayrre@gmail.myst
DITYAD	Mapqymg	mapqymg.dityad@gmail.myst
DJUM	Ufzoak	ufzoak.djum@gmail.myst
DKYEAI	Xfekyq	xfekyq.dkyeai@gmail.myst
DMOB	Ocriuh	ocriuh.dmob@gmail.myst
DMUC	Ugjoer	ugjoer.dmuc@gmail.myst
DOGGIWY GZAUFFO	Matog	matog.gzauffo@gmail.myst
DOI	Ond	ond.doi@gmail.myst
DOWWULA WMIYQQO	Bigow	bigow.wmiyqqo@gmail.myst
DOYGADA	Jsazz	jsazz.doygada@gmail.myst
DOZGYIVVU	Vuseb	vuseb.dozgyivvu@gmail.myst
DRAX	Altiog	altiog.drax@gmail.myst
DRIYOU	Mfyrip	mfyrip.driyou@gmail.myst
DU	Rypg	rypg.du@gmail.myst
DU	Sivg	sivg.du@gmail.myst
DUARUK	Wmudet	wmudet.duaruk@gmail.myst
DUBEYD	Myvfemk	myvfemk.dubeyd@gmail.myst
DUCATVDIM	Uihh	uihh.ducatvdim@gmail.myst
DUCYED	Gejnygx	gejnygx.ducyed@gmail.myst
DUEFUZ	Scudim	scudim.duefuz@gmail.myst
DUGZYOXXE	Xewil	xewil.dugzyoxxe@gmail.myst
DUIMUT	Qhudax	qhudax.duimut@gmail.myst
DUIQUL	Pnudow	pnudow.duiqul@gmail.myst
DUMAOD	Sonvasc	sonvasc.dumaod@gmail.myst
DUO	Und	und.duo@gmail.myst
DUTS	Pe	pe.duts@gmail.myst
DVUL	Ukhyir	ukhyir.dvul@gmail.myst
DWOEIU	Lgewov	lgewov.dwoeiu@gmail.myst
DXEYAI	Mnyxeq	mnyxeq.dxeyai@gmail.myst
DYACYB	Kwydej	kwydej.dyacyb@gmail.myst
DYIWUDU	Hbujj	hbujj.dyiwudu@gmail.myst
DYO	Iu	iu.dyo@gmail.myst
DYOZUDU	Mjuff	mjuff.dyozudu@gmail.myst
DYPLOUSSE	Sewaf	sewaf.dyplousse@gmail.myst
DYPUID	Hiqnuhf	hiqnuhf.dypuid@gmail.myst
DYTEOD	Congecw	congecw.dyteod@gmail.myst
DYUTADA	Crapp	crapp.dyutada@gmail.myst
EBDESGIY	Pene	pene.ebdesgiy@gmail.myst
EBSEJKIY	Leqe	leqe.ebsejkiy@gmail.myst
ECXEFRIO	Gewe	gewe.ecxefrio@gmail.myst
EDJEFVIY	Lewe	lewe.edjefviy@gmail.myst
EDNEQCAY	Kege	kege.edneqcay@gmail.myst
EDZEXWIA	Sene	sene.edzexwia@gmail.myst
EHKEWZYO	Seqe	seqe.ehkewzyo@gmail.myst
EHLERKUA	Peje	peje.ehlerkua@gmail.myst
EJDETGYI	Veqe	veqe.ejdetgyi@gmail.myst
EJKETBOY	Fege	fege.ejketboy@gmail.myst
EJXELFYO	Pehe	pehe.ejxelfyo@gmail.myst
EKFEGHUI	Teme	teme.ekfeghui@gmail.myst
EKNEJGOU	Heme	heme.eknejgou@gmail.myst
ENGECRAO	Dewe	dewe.engecrao@gmail.myst
ENMERVAO	Kefe	kefe.enmervao@gmail.myst
EQLENVAY	Hede	hede.eqlenvay@gmail.myst
ERXEJCIU	Wede	wede.erxejciu@gmail.myst
ESWECHAO	Beqe	beqe.eswechao@gmail.myst
ESZEMHOI	Gete	gete.eszemhoi@gmail.myst
ETBEZQUO	Newe	newe.etbezquo@gmail.myst
EVFEMSOY	Deke	deke.evfemsoy@gmail.myst
EVWEXTOI	Heme	heme.evwextoi@gmail.myst
EXKEVBYA	Cewe	cewe.exkevbya@gmail.myst
EXLESWUO	Peqe	peqe.exleswuo@gmail.myst
EXMEJTYA	Sede	sede.exmejtya@gmail.myst
EZJEPTYI	Qeke	qeke.ezjeptyi@gmail.myst
FACM	Ri	ri.facm@gmail.myst
FAE	Agf	agf.fae@gmail.myst
FAI	Yo	yo.fai@gmail.myst
FARRYPE RMIODDA	Qikar	qikar.rmiodda@gmail.myst
FAU	Axf	axf.fau@gmail.myst
FAUBAT	Dmafyg	dmafyg.faubat@gmail.myst
FAUJAP	Mzafyd	mzafyd.faujap@gmail.myst
FAUKAL	Pbafiw	pbafiw.faukal@gmail.myst
FAY	Apf	apf.fay@gmail.myst
FAY	Jiqhty	jiqhty.fay@gmail.myst
FBEL	Ewzoin	ewzoin.fbel@gmail.myst
FDUAEO	Kvadub	kvadub.fduaeo@gmail.myst
FEA	Ou	ou.fea@gmail.myst
FEBBISA BTYUJJE	Qyxeb	qyxeb.btyujje@gmail.myst
FEIMAFA	Vkass	vkass.feimafa@gmail.myst
FEJYGLFAR	Eazz	eazz.fejyglfar@gmail.myst
FELK	Wy	wy.felk@gmail.myst
FEOJEB	Dzefyh	dzefyh.feojeb@gmail.myst
FEPPUCA PBYOVVE	Hyxep	hyxep.pbyovve@gmail.myst
FESSOPA SKUYRRE	Wuhes	wuhes.skuyrre@gmail.myst
FETHUIXXA	Xalod	xalod.fethuixxa@gmail.myst
FEU	Ao	ao.feu@gmail.myst
FEU	Epf	epf.feu@gmail.myst
FEZUAF	Gabwugs	gabwugs.fezuaf@gmail.myst
FGON	Omduej	omduej.fgon@gmail.myst
FGYEAI	Lkegyq	lkegyq.fgyeai@gmail.myst
FI	Qyds	qyds.fi@gmail.myst
FIQAUF	Tulvatd	tulvatd.fiqauf@gmail.myst
FIQEGXFOS	Iovv	iovv.fiqegxfos@gmail.myst
FIUMID	Hqifyl	hqifyl.fiumid@gmail.myst
FIWWALO WMUYKKI	Tuxiw	tuxiw.wmuykki@gmail.myst
FIWWYNA WQOUKKI	Xopiw	xopiw.wqoukki@gmail.myst
FIWWYXO WQUASSI	Tugiw	tugiw.wquassi@gmail.myst
FIWYCNFEL	Iedd	iedd.fiwycnfel@gmail.myst
FIYJIS	Pmifeb	pmifeb.fiyjis@gmail.myst
FOI	Ey	ey.foi@gmail.myst
FOQT	Cu	cu.foqt@gmail.myst
FOU	Ea	ea.fou@gmail.myst
FOUROP	Glofes	glofes.fourop@gmail.myst
FOVYAF	Qagjyqr	qagjyqr.fovyaf@gmail.myst
FOY	Otf	otf.foy@gmail.myst
FRAYUI	Cjyrah	cjyrah.frayui@gmail.myst
FSAUYI	Lwusan	lwusan.fsauyi@gmail.myst
FU	Pids	pids.fu@gmail.myst
FU	Tagn	tagn.fu@gmail.myst
FU	Xelp	xelp.fu@gmail.myst
FUIQUJ	Lmufyt	lmufyt.fuiquj@gmail.myst
FUKOPZFES	Ueqq	ueqq.fukopzfes@gmail.myst
FUSAIF	Nivmanz	nivmanz.fusaif@gmail.myst
FUSYIF	Winrywv	winrywv.fusyif@gmail.myst
FUYVUC	Zkufep	zkufep.fuyvuc@gmail.myst
FUZEYF	Tyjketg	tyjketg.fuzeyf@gmail.myst
FVAG	Acsoyd	acsoyd.fvag@gmail.myst
FVIYAE	Tryvim	tryvim.fviyae@gmail.myst
FY	Cith	cith.fy@gmail.myst
FY	Niwj	niwj.fy@gmail.myst
FYANOFO	Qcojj	qcojj.fyanofo@gmail.myst
FYDDAPI DKUEJJY	Wugyd	wugyd.dkuejjy@gmail.myst
FYE	Oa	oa.fye@gmail.myst
FYGGATE GZUOBBY	Lusyg	lusyg.gzuobby@gmail.myst
FYHHEBA HLOIJJY	Nocyh	nocyh.hloijjy@gmail.myst
FYI	Yrf	yrf.fyi@gmail.myst
FYIDYP	Htyfar	htyfar.fyidyp@gmail.myst
FYLLIDA LWUEMMY	Tupyl	tupyl.lwuemmy@gmail.myst
FYOKYN	Mbyfiw	mbyfiw.fyokyn@gmail.myst
FYRZ	Xe	xe.fyrz@gmail.myst
FYTTUJA TVIOQQY	Winyt	winyt.tvioqqy@gmail.myst
FYUSYX	Njyfiw	njyfiw.fyusyx@gmail.myst
FZIAEY	Hmazil	hmazil.fziaey@gmail.myst
GABBUDO BLEYSSA	Menab	menab.bleyssa@gmail.myst
GAHHYZU HDEIKKA	Pejah	pejah.hdeikka@gmail.myst
GAQH	Py	py.gaqh@gmail.myst
GAQIEG	Keprikz	keprikz.gaqieg@gmail.myst
GAQJOYNNE	Nevih	nevih.gaqjoynne@gmail.myst
GATZ	Wo	wo.gatz@gmail.myst
GAU	Oy	oy.gau@gmail.myst
GAUSAP	Tlagej	tlagej.gausap@gmail.myst
GAWWUXO WFEILLA	Jebaw	jebaw.wfeilla@gmail.myst
GAXIVCGYZ	Ayrr	ayrr.gaxivcgyz@gmail.myst
GAYWAS	Nkager	nkager.gaywas@gmail.myst
GAZEOG	Focxefw	focxefw.gazeog@gmail.myst
GCYUAE	Qbucyt	qbucyt.gcyuae@gmail.myst
GE	Hicm	hicm.ge@gmail.myst
GE	Nujx	nujx.ge@gmail.myst
GE	Taxk	taxk.ge@gmail.myst
GEA	Epg	epg.gea@gmail.myst
GEA	Evg	evg.gea@gmail.myst
GEBUQLGAX	Eakk	eakk.gebuqlgax@gmail.myst
GECB	Na	na.gecb@gmail.myst
GEDAKXGIN	Eill	eill.gedakxgin@gmail.myst
GEJJAPO JWUYSSE	Buxej	buxej.jwuysse@gmail.myst
GERRASO RZYIWWE	Myher	myher.rzyiwwe@gmail.myst
GETYUG	Suhrysl	suhrysl.getyug@gmail.myst
GEVAIG	Tisratl	tisratl.gevaig@gmail.myst
GEY	Ehg	ehg.gey@gmail.myst
GEY	Ia	ia.gey@gmail.myst
GIATEGE	Rsell	rsell.giatege@gmail.myst
GIHOAG	Xarfoxq	xarfoxq.gihoag@gmail.myst
GIO	Syxqbo	syxqbo.gio@gmail.myst
GLIAUO	Jralix	jralix.gliauo@gmail.myst
GLUYAI	Dryluc	dryluc.gluyai@gmail.myst
GMAL	Azniyf	azniyf.gmal@gmail.myst
GO	Bezn	bezn.go@gmail.myst
GOA	Iy	iy.goa@gmail.myst
GOA	Qulmsa	qulmsa.goa@gmail.myst
GOATYGY	Khyxx	khyxx.goatygy@gmail.myst
GOI	Rehtfi	rehtfi.goi@gmail.myst
GOJUYG	Nywbunc	nywbunc.gojuyg@gmail.myst
GOLSUIPPE	Pecyx	pecyx.golsuippe@gmail.myst
GOTCEUMMY	Mypil	mypil.gotceummy@gmail.myst
GOU	Oqg	oqg.gou@gmail.myst
GOUWOH	Qdogyk	qdogyk.gouwoh@gmail.myst
GOWAIG	Lizcalp	lizcalp.gowaig@gmail.myst
GPIAEU	Scapik	scapik.gpiaeu@gmail.myst
GQAOEU	Dfoqat	dfoqat.gqaoeu@gmail.myst
GSAM	Axcioj	axcioj.gsam@gmail.myst
GTIEAU	Bzetil	bzetil.gtieau@gmail.myst
GU	Vodr	vodr.gu@gmail.myst
GUAHIGI	Tqidd	tqidd.guahigi@gmail.myst
GUDC	Si	si.gudc@gmail.myst
GUELUX	Dtugaw	dtugaw.guelux@gmail.myst
GUESUD	Hvugab	hvugab.guesud@gmail.myst
GUI	Oy	oy.gui@gmail.myst
GUNBYOWWI	Wixaf	wixaf.gunbyowwi@gmail.myst
GUOZIGI	Mxiss	mxiss.guozigi@gmail.myst
GUSMIYBBE	Beqaf	beqaf.gusmiybbe@gmail.myst
GUTREILLO	Lomas	lomas.gutreillo@gmail.myst
GUXISMGOW	Uonn	uonn.guxismgow@gmail.myst
GUY	Ai	ai.guy@gmail.myst
GUYDOGO	Hlott	hlott.guydogo@gmail.myst
GVAB	Adtuof	adtuof.gvab@gmail.myst
GWOEYU	Bxewol	bxewol.gwoeyu@gmail.myst
GYA	Qoflda	qoflda.gya@gmail.myst
GYEKYZ	Msygah	msygah.gyekyz@gmail.myst
GYHIKTGAJ	Yall	yall.gyhiktgaj@gmail.myst
GYI	Japkni	japkni.gyi@gmail.myst
GYKISJGAP	Yazz	yazz.gykisjgap@gmail.myst
GYKKOHA KJUEWWY	Mupyk	mupyk.kjuewwy@gmail.myst
GYVUCNGAS	Yapp	yapp.gyvucngas@gmail.myst
GYWEIG	Miszemt	miszemt.gyweig@gmail.myst
GZEIOU	Brizet	brizet.gzeiou@gmail.myst
HAI	Aqh	aqh.hai@gmail.myst
HAJIYH	Tyvqitc	tyvqitc.hajiyh@gmail.myst
HAJJUKI JZYOQQA	Sylaj	sylaj.jzyoqqa@gmail.myst
HAKUMVHEX	Aedd	aedd.hakumvhex@gmail.myst
HAO	Eu	eu.hao@gmail.myst
HAQQUCI QMYETTA	Lywaq	lywaq.qmyetta@gmail.myst
HAQUJBHEZ	Aell	aell.haqujbhez@gmail.myst
HARUVTHOK	Aoqq	aoqq.haruvthok@gmail.myst
HAU	Ajh	ajh.hau@gmail.myst
HAU	Aph	aph.hau@gmail.myst
HAU	Yi	yi.hau@gmail.myst
HAVK	Te	te.havk@gmail.myst
HAVUWNHYT	Ayff	ayff.havuwnhyt@gmail.myst
HAXF	So	so.haxf@gmail.myst
HAY	Eo	eo.hay@gmail.myst
HCIOAU	Zmocib	zmocib.hcioau@gmail.myst
HCYIUE	Mqicyn	mqicyn.hcyiue@gmail.myst
HDYEIU	Kledyj	kledyj.hdyeiu@gmail.myst
HE	Dotz	dotz.he@gmail.myst
HEA	Eth	eth.hea@gmail.myst
HEA	Ropkna	ropkna.hea@gmail.myst
HEGR	Ko	ko.hegr@gmail.myst
HEGURBHYF	Eyzz	eyzz.hegurbhyf@gmail.myst
HEJOSCHUG	Eunn	eunn.hejoschug@gmail.myst
HENBOAXXU	Xusiw	xusiw.henboaxxu@gmail.myst
HENNOQI NTYAPPE	Vyzen	vyzen.ntyappe@gmail.myst
HEO	Waszco	waszco.heo@gmail.myst
HEPOLZHAS	Eagg	eagg.hepolzhas@gmail.myst
HESOIH	Rigmorc	rigmorc.hesoih@gmail.myst
HEST	Na	na.hest@gmail.myst
HETOSCHAF	Eabb	eabb.hetoschaf@gmail.myst
HEY	Ebh	ebh.hey@gmail.myst
HEY	Egh	egh.hey@gmail.myst
HI	Kuzd	kuzd.hi@gmail.myst
HIDNUOVVY	Vyceq	vyceq.hidnuovvy@gmail.myst
HIUPOHO	Ksoxx	ksoxx.hiupoho@gmail.myst
HIUVIR	Mbihyq	mbihyq.hiuvir@gmail.myst
HIXABSHYP	Iytt	iytt.hixabshyp@gmail.myst
HIYDAHA	Qxacc	qxacc.hiydaha@gmail.myst
HMIEYA	Zwemic	zwemic.hmieya@gmail.myst
HMUEAI	Znemur	znemur.hmueai@gmail.myst
HOAFYHY	Gqybb	gqybb.hoafyhy@gmail.myst
HOEQOF	Wjohyt	wjohyt.hoeqof@gmail.myst
HOFVIYNNA	Naqub	naqub.hofviynna@gmail.myst
HOMYAH	Wapdywv	wapdywv.homyah@gmail.myst
HOTEYH	Nyqlend	nyqlend.hoteyh@gmail.myst
HOU	Veqtru	veqtru.hou@gmail.myst
HOY	Ae	ae.hoy@gmail.myst
HOYPOQ	Mjohen	mjohen.hoypoq@gmail.myst
HU	Qitf	qitf.hu@gmail.myst
HUA	Uth	uth.hua@gmail.myst
HUACOHO	Frott	frott.huacoho@gmail.myst
HUE	Ufh	ufh.hue@gmail.myst
HUEGOHO	Rfomm	rfomm.huegoho@gmail.myst
HUGEIH	Xivwexm	xivwexm.hugeih@gmail.myst
HUO	Ugh	ugh.huo@gmail.myst
HUQTYEVVA	Vanox	vanox.huqtyevva@gmail.myst
HUVEKLHOM	Uorr	uorr.huveklhom@gmail.myst
HUYMAHA	Wvapp	wvapp.huymaha@gmail.myst
HUYQUK	Dwuhaj	dwuhaj.huyquk@gmail.myst
HUYTUC	Kguhaq	kguhaq.huytuc@gmail.myst
HVAYIE	Xdyvag	xdyvag.hvayie@gmail.myst
HY	Vinb	vinb.hy@gmail.myst
HYDEUH	Juknejm	juknejm.hydeuh@gmail.myst
HYLBAUWWI	Witof	witof.hylbauwwi@gmail.myst
HYPK	Li	li.hypk@gmail.myst
HYQQIRE QFUOVVY	Sucyq	sucyq.qfuovvy@gmail.myst
HYSLEOGGI	Giqum	giqum.hysleoggi@gmail.myst
HYTTOFA TLEIQQY	Vegyt	vegyt.tleiqqy@gmail.myst
HYU	Segbju	segbju.hyu@gmail.myst
HYWXAILLE	Lenuk	lenuk.hywxaille@gmail.myst
IBLIZPOU	Siri	siri.iblizpou@gmail.myst
IGJISQUO	Xici	xici.igjisquo@gmail.myst
IJXIRMUA	Vici	vici.ijxirmua@gmail.myst
IPBIKQOA	Niji	niji.ipbikqoa@gmail.myst
IPRIKLYE	Gizi	gizi.ipriklye@gmail.myst
IQCIFWEO	Ziri	ziri.iqcifweo@gmail.myst
IVQITBOY	Hici	hici.ivqitboy@gmail.myst
IXBIKMUO	Lidi	lidi.ixbikmuo@gmail.myst
JA	Foxq	foxq.ja@gmail.myst
JA	Hiqt	hiqt.ja@gmail.myst
JA	Mokl	mokl.ja@gmail.myst
JABOUJ	Dulgodm	dulgodm.jabouj@gmail.myst
JAGT	Qi	qi.jagt@gmail.myst
JAI	Afj	afj.jai@gmail.myst
JAO	Sizlro	sizlro.jao@gmail.myst
JAOMYJY	Ctyzz	ctyzz.jaomyjy@gmail.myst
JARUFQJIG	Aizz	aizz.jarufqjig@gmail.myst
JAU	Afj	afj.jau@gmail.myst
JAU	Kyzdru	kyzdru.jau@gmail.myst
JBIF	Idkoyl	idkoyl.jbif@gmail.myst
JDER	Ensyup	ensyup.jder@gmail.myst
JEA	Oi	oi.jea@gmail.myst
JECCOHY CVAUNNE	Taqec	taqec.cvaunne@gmail.myst
JEDQIULLY	Lytaf	lytaf.jedqiully@gmail.myst
JEI	Tavgri	tavgri.jei@gmail.myst
JEKV	Po	po.jekv@gmail.myst
JEO	Lupfco	lupfco.jeo@gmail.myst
JEO	Uy	uy.jeo@gmail.myst
JEY	Tufbcy	tufbcy.jey@gmail.myst
JEYGEV	Dtejoc	dtejoc.jeygev@gmail.myst
JI	Hafl	hafl.ji@gmail.myst
JI	Lerz	lerz.ji@gmail.myst
JIA	Ryvmka	ryvmka.jia@gmail.myst
JIESIN	Hzijot	hzijot.jiesin@gmail.myst
JISP	Ku	ku.jisp@gmail.myst
JIUHOJO	Zgobb	zgobb.jiuhojo@gmail.myst
JIY	Eu	eu.jiy@gmail.myst
JMUOIE	Hgomun	hgomun.jmuoie@gmail.myst
JOANOH	Plojec	plojec.joanoh@gmail.myst
JOCCEVU CZYAGGO	Lyxoc	lyxoc.czyaggo@gmail.myst
JOI	Gytfsi	gytfsi.joi@gmail.myst
JOIQYJY	Cnyss	cnyss.joiqyjy@gmail.myst
JOPTYIRRA	Raqef	raqef.joptyirra@gmail.myst
JOQG	Li	li.joqg@gmail.myst
JORISCJUT	Ouxx	ouxx.joriscjut@gmail.myst
JORP	Ca	ca.jorp@gmail.myst
JOTTINA TDEYSSO	Remot	remot.tdeysso@gmail.myst
JOU	Owj	owj.jou@gmail.myst
JPOD	Orfyuw	orfyuw.jpod@gmail.myst
JU	Zylv	zylv.ju@gmail.myst
JUBWOYGGA	Gavix	gavix.jubwoygga@gmail.myst
JUE	Yi	yi.jue@gmail.myst
JUENOJO	Vloww	vloww.juenojo@gmail.myst
JUGRAYHHI	Hiqet	hiqet.jugrayhhi@gmail.myst
JUGXAIMME	Mezol	mezol.jugxaimme@gmail.myst
JUI	Gondqi	gondqi.jui@gmail.myst
JUPAIJ	Cizsacx	cizsacx.jupaij@gmail.myst
JUWYAJ	Qanmyqz	qanmyqz.juwyaj@gmail.myst
JXIAEO	Dsaxim	dsaxim.jxiaeo@gmail.myst
JYBEVHJOP	Yoqq	yoqq.jybevhjop@gmail.myst
JYDS	Qi	qi.jyds@gmail.myst
JYE	Gudsle	gudsle.jye@gmail.myst
JYO	Ua	ua.jyo@gmail.myst
JYO	Ue	ue.jyo@gmail.myst
JYO	Yhj	yhj.jyo@gmail.myst
JZAYEO	Xmyzaf	xmyzaf.jzayeo@gmail.myst
KACERGKOZ	Aohh	aohh.kacergkoz@gmail.myst
KAE	Dypmxe	dypmxe.kae@gmail.myst
KAFYCLKUW	Auzz	auzz.kafyclkuw@gmail.myst
KAIJAW	Gxakel	gxakel.kaijaw@gmail.myst
KARROGI RTYULLA	Wyzar	wyzar.rtyulla@gmail.myst
KATYMSKEB	Aegg	aegg.katymskeb@gmail.myst
KAU	Bypfsu	bypfsu.kau@gmail.myst
KAVTEYCCO	Coluj	coluj.kavteycco@gmail.myst
KAXXYZU XDOIGGA	Qolax	qolax.xdoigga@gmail.myst
KAY	Avk	avk.kay@gmail.myst
KBIAEO	Xwabih	xwabih.kbiaeo@gmail.myst
KEA	Uy	uy.kea@gmail.myst
KEHQAOZZI	Zijyn	zijyn.kehqaozzi@gmail.myst
KEI	Gathpi	gathpi.kei@gmail.myst
KEJGAYCCO	Cobun	cobun.kejgaycco@gmail.myst
KELLAWU LCIYJJE	Nirel	nirel.lciyjje@gmail.myst
KENUOK	Zobjuzf	zobjuzf.kenuok@gmail.myst
KEO	Epk	epk.keo@gmail.myst
KETTUPO TFYALLE	Gyjet	gyjet.tfyalle@gmail.myst
KETUQGKOX	Eoll	eoll.ketuqgkox@gmail.myst
KEU	Ao	ao.keu@gmail.myst
KEU	Elk	elk.keu@gmail.myst
KEU	Iy	iy.keu@gmail.myst
KEU	Jyhgxu	jyhgxu.keu@gmail.myst
KFOEYI	Cmefod	cmefod.kfoeyi@gmail.myst
KFOUYA	Rjufom	rjufom.kfouya@gmail.myst
KGYEIU	Fnegyx	fnegyx.kgyeiu@gmail.myst
KHAV	Amciyn	amciyn.khav@gmail.myst
KI	Gosz	gosz.ki@gmail.myst
KI	Qyfb	qyfb.ki@gmail.myst
KIQASXKEF	Iepp	iepp.kiqasxkef@gmail.myst
KJEZ	Ewfyul	ewfyul.kjez@gmail.myst
KJYH	Yrqaif	yrqaif.kjyh@gmail.myst
KMEF	Edjaus	edjaus.kmef@gmail.myst
KMOX	Obvuaq	obvuaq.kmox@gmail.myst
KO	Facb	facb.ko@gmail.myst
KOHEYK	Qydneqg	qydneqg.koheyk@gmail.myst
KOND	Ba	ba.kond@gmail.myst
KOREWTKYM	Oydd	oydd.korewtkym@gmail.myst
KOTF	Di	di.kotf@gmail.myst
KOWJ	Mi	mi.kowj@gmail.myst
KOYLOG	Vcokar	vcokar.koylog@gmail.myst
KRAS	Afbeyx	afbeyx.kras@gmail.myst
KUESOKO	Vcobb	vcobb.kuesoko@gmail.myst
KUGH	Py	py.kugh@gmail.myst
KUHEOK	Ronmerf	ronmerf.kuheok@gmail.myst
KUI	Uxk	uxk.kui@gmail.myst
KUPDAIFFE	Fezyr	fezyr.kupdaiffe@gmail.myst
KUQNIESSA	Sazyb	sazyb.kuqniessa@gmail.myst
KUSAIK	Qilwaqb	qilwaqb.kusaik@gmail.myst
KUY	Urk	urk.kuy@gmail.myst
KUYLUP	Mxuket	mxuket.kuylup@gmail.myst
KWUV	Urzeyt	urzeyt.kwuv@gmail.myst
KYA	Ypk	ypk.kya@gmail.myst
KYDS	Re	re.kyds@gmail.myst
KYFMUOWWA	Wasil	wasil.kyfmuowwa@gmail.myst
KYGB	Fu	fu.kygb@gmail.myst
KYJV	Ca	ca.kyjv@gmail.myst
KYOGYZ	Mhykax	mhykax.kyogyz@gmail.myst
KYQT	Wo	wo.kyqt@gmail.myst
KYRF	Ne	ne.kyrf@gmail.myst
KYZCUEMMI	Mihod	mihod.kyzcuemmi@gmail.myst
KYZN	Po	po.kyzn@gmail.myst
LABEYL	Fydjefw	fydjefw.labeyl@gmail.myst
LAI	Azl	azl.lai@gmail.myst
LAI	Qukzmi	qukzmi.lai@gmail.myst
LAIFAG	Dxalem	dxalem.laifag@gmail.myst
LAJH	Ti	ti.lajh@gmail.myst
LAPF	Xu	xu.lapf@gmail.myst
LATIOL	Koxbikd	koxbikd.latiol@gmail.myst
LAU	Adl	adl.lau@gmail.myst
LAU	Gyzdbu	gyzdbu.lau@gmail.myst
LAU	Tifjmu	tifjmu.lau@gmail.myst
LAUPELE	Xbegg	xbegg.laupele@gmail.myst
LAUZAN	Hbalec	hbalec.lauzan@gmail.myst
LAWWUFI WJOYNNA	Sovaw	sovaw.wjoynna@gmail.myst
LAY	Aql	aql.lay@gmail.myst
LDOIEY	Nbidof	nbidof.ldoiey@gmail.myst
LEA	Iu	iu.lea@gmail.myst
LEBH	To	to.lebh@gmail.myst
LECCANO CQUIZZE	Mutec	mutec.cquizze@gmail.myst
LEMMAGO MRIUFFE	Zicem	zicem.mriuffe@gmail.myst
LEO	Ia	ia.leo@gmail.myst
LEO	Iu	iu.leo@gmail.myst
LERIFTLOK	Eoww	eoww.leriftlok@gmail.myst
LESZ	Xo	xo.lesz@gmail.myst
LEUKET	Hcelym	hcelym.leuket@gmail.myst
LEVG	Xi	xi.levg@gmail.myst
LEXXYGI XHOUMME	Wosex	wosex.xhoumme@gmail.myst
LEYSULU	Qgucc	qgucc.leysulu@gmail.myst
LFOT	Oqxaug	oqxaug.lfot@gmail.myst
LHEAYU	Jfahex	jfahex.lheayu@gmail.myst
LHOQ	Owgiut	owgiut.lhoq@gmail.myst
LIA	Igl	igl.lia@gmail.myst
LIDFUONNE	Nebyq	nebyq.lidfuonne@gmail.myst
LIE	Ao	ao.lie@gmail.myst
LIHB	Ry	ry.lihb@gmail.myst
LIRAEL	Ketfakh	ketfakh.lirael@gmail.myst
LIWUVXLEM	Iecc	iecc.liwuvxlem@gmail.myst
LNEX	Egqyuk	egqyuk.lnex@gmail.myst
LOA	Kerpxa	kerpxa.loa@gmail.myst
LOAHOR	Gjolyt	gjolyt.loahor@gmail.myst
LOAHOR	Qvolux	qvolux.loahor@gmail.myst
LOI	Quwjzi	quwjzi.loi@gmail.myst
LORBIUQQY	Qyseh	qyseh.lorbiuqqy@gmail.myst
LOU	Dajxvu	dajxvu.lou@gmail.myst
LQYEAO	Zseqyx	zseqyx.lqyeao@gmail.myst
LSAG	Ackuiz	ackuiz.lsag@gmail.myst
LTAOEY	Xnotad	xnotad.ltaoey@gmail.myst
LU	Jyhv	jyhv.lu@gmail.myst
LUBOAL	Qagnoqt	qagnoqt.luboal@gmail.myst
LUCEYL	Jybsejq	jybsejq.luceyl@gmail.myst
LUE	Cyznqe	cyznqe.lue@gmail.myst
LUE	Ukl	ukl.lue@gmail.myst
LUE	Zotsfe	zotsfe.lue@gmail.myst
LUIKOLO	Rmoxx	rmoxx.luikolo@gmail.myst
LUONUF	Cmulaw	cmulaw.luonuf@gmail.myst
LURK	So	so.lurk@gmail.myst
LUXXORY XSAIHHU	Gazux	gazux.xsaihhu@gmail.myst
LUYDILI	Stiqq	stiqq.luydili@gmail.myst
LWYEOU	Gjewyz	gjewyz.lwyeou@gmail.myst
LXIB	Icraov	icraov.lxib@gmail.myst
LY	Fapk	fapk.ly@gmail.myst
LY	Gopw	gopw.ly@gmail.myst
LY	Musp	musp.ly@gmail.myst
LYE	Ybl	ybl.lye@gmail.myst
LYFACSLUN	Yutt	yutt.lyfacslun@gmail.myst
LYFURNLEC	Yekk	yekk.lyfurnlec@gmail.myst
LYIFELE	Grexx	grexx.lyifele@gmail.myst
LYMMETI MXUOKKY	Pusym	pusym.mxuokky@gmail.myst
LYMUXVLEZ	Yehh	yehh.lymuxvlez@gmail.myst
LYO	Yfl	yfl.lyo@gmail.myst
LYOMYG	Rzylex	rzylex.lyomyg@gmail.myst
LYTFAUJJE	Jevic	jevic.lytfaujje@gmail.myst
LYTTORE TZAIHHY	Qawyt	qawyt.tzaihhy@gmail.myst
MA	Xuqt	xuqt.ma@gmail.myst
MABBUJI BHYOCCA	Pyzab	pyzab.bhyocca@gmail.myst
MAO	Abm	abm.mao@gmail.myst
MAU	Acm	acm.mau@gmail.myst
MAU	Eo	eo.mau@gmail.myst
MAUKOMO	Wzocc	wzocc.maukomo@gmail.myst
MAY	Apm	apm.may@gmail.myst
MAY	Ui	ui.may@gmail.myst
MAYPOMO	Qworr	qworr.maypomo@gmail.myst
MAYWIMI	Qtipp	qtipp.maywimi@gmail.myst
ME	Cork	cork.me@gmail.myst
MEDNYABBU	Bupir	bupir.mednyabbu@gmail.myst
MEI	Oy	oy.mei@gmail.myst
MEIQAMA	Hdall	hdall.meiqama@gmail.myst
MEIZEK	Xjemuc	xjemuc.meizek@gmail.myst
MEOZES	Flemig	flemig.meozes@gmail.myst
MEPK	Va	va.mepk@gmail.myst
MEU	Ya	ya.meu@gmail.myst
MGUB	Ufceoz	ufceoz.mgub@gmail.myst
MI	Dokv	dokv.mi@gmail.myst
MIA	Ilm	ilm.mia@gmail.myst
MIAKYMY	Rfygg	rfygg.miakymy@gmail.myst
MIFKUOSSE	Sezyq	sezyq.mifkuosse@gmail.myst
MIGGESU GPOYZZI	Qobig	qobig.gpoyzzi@gmail.myst
MIUGIQ	Spimyb	spimyb.miugiq@gmail.myst
MIY	Ivm	ivm.miy@gmail.myst
MO	Bevk	bevk.mo@gmail.myst
MO	Fajv	fajv.mo@gmail.myst
MO	Fetz	fetz.mo@gmail.myst
MOA	Sindpa	sindpa.moa@gmail.myst
MOE	Ay	ay.moe@gmail.myst
MOE	Yi	yi.moe@gmail.myst
MOI	Jeswni	jeswni.moi@gmail.myst
MOIHEME	Rzecc	rzecc.moiheme@gmail.myst
MOQIBVMUC	Ouxx	ouxx.moqibvmuc@gmail.myst
MOU	Olm	olm.mou@gmail.myst
MOUXAMA	Vwakk	vwakk.mouxama@gmail.myst
MOWAFDMEG	Oell	oell.mowafdmeg@gmail.myst
MU	Biht	biht.mu@gmail.myst
MU	Fast	fast.mu@gmail.myst
MUCCEKO CLIAZZU	Nibuc	nibuc.cliazzu@gmail.myst
MUEKOMO	Csobb	csobb.muekomo@gmail.myst
MUFIBVMAJ	Uaxx	uaxx.mufibvmaj@gmail.myst
MUOWUF	Lrumyk	lrumyk.muowuf@gmail.myst
MUROQGMYC	Uyff	uyff.muroqgmyc@gmail.myst
MUY	Ia	ia.muy@gmail.myst
MUYCUJ	Ksumab	ksumab.muycuj@gmail.myst
MVAR	Ahbuop	ahbuop.mvar@gmail.myst
MWED	Eqcoib	eqcoib.mwed@gmail.myst
MXYV	Ygroaz	ygroaz.mxyv@gmail.myst
MY	Lifj	lifj.my@gmail.myst
MYA	Iu	iu.mya@gmail.myst
MYBBIQO BTUAGGY	Juryb	juryb.btuaggy@gmail.myst
MYBL	Ka	ka.mybl@gmail.myst
MYKKUFI KPOEWWY	Sonyk	sonyk.kpoewwy@gmail.myst
MYPLAUJJE	Jebog	jebog.myplaujje@gmail.myst
MYU	Ei	ei.myu@gmail.myst
MYVULBMAN	Yaxx	yaxx.myvulbman@gmail.myst
MYXBIALLU	Lugep	lugep.myxbiallu@gmail.myst
NABM	Li	li.nabm@gmail.myst
NAGF	Mi	mi.nagf@gmail.myst
NAI	Oe	oe.nai@gmail.myst
NAIMUNU	Djull	djull.naimunu@gmail.myst
NAMEON	Zotbezw	zotbezw.nameon@gmail.myst
NAO	Cuphlo	cuphlo.nao@gmail.myst
NAO	Sudlwo	sudlwo.nao@gmail.myst
NAOTAH	Fqaniz	fqaniz.naotah@gmail.myst
NAROZLNUH	Autt	autt.narozlnuh@gmail.myst
NAYDAJ	Rganoc	rganoc.naydaj@gmail.myst
NDES	Eqtiuv	eqtiuv.ndes@gmail.myst
NE	Ridc	ridc.ne@gmail.myst
NECGUYQQA	Qalih	qalih.necguyqqa@gmail.myst
NECYRJNIT	Eivv	eivv.necyrjnit@gmail.myst
NEFB	Hy	hy.nefb@gmail.myst
NEIRONO	Fzocc	fzocc.neirono@gmail.myst
NEO	Cydrzo	cydrzo.neo@gmail.myst
NEO	Ia	ia.neo@gmail.myst
NEO	Rukvgo	rukvgo.neo@gmail.myst
NEOGEF	Rwenuk	rwenuk.neogef@gmail.myst
NEOTANA	Gjahh	gjahh.neotana@gmail.myst
NEXGIYZZU	Zurat	zurat.nexgiyzzu@gmail.myst
NEY	Ao	ao.ney@gmail.myst
NEZIGRNYH	Eyqq	eyqq.nezigrnyh@gmail.myst
NI	Qeds	qeds.ni@gmail.myst
NI	Ruhg	ruhg.ni@gmail.myst
NIFJOETTY	Tyvah	tyvah.nifjoetty@gmail.myst
NIGL	Me	me.nigl@gmail.myst
NIHULJNED	Iepp	iepp.nihuljned@gmail.myst
NIROAN	Samzosx	samzosx.niroan@gmail.myst
NIZW	Po	po.nizw@gmail.myst
NIZZAHY ZBOETTI	Joviz	joviz.zboetti@gmail.myst
NJAIEU	Lbijaf	lbijaf.njaieu@gmail.myst
NJAUEI	Gpujab	gpujab.njauei@gmail.myst
NJYL	Ysheir	ysheir.njyl@gmail.myst
NKIUYE	Mbukiw	mbukiw.nkiuye@gmail.myst
NMIAEY	Qhamiv	qhamiv.nmiaey@gmail.myst
NOBBUQI BGEYVVO	Cetob	cetob.bgeyvvo@gmail.myst
NOCCAJU CXYEDDO	Byloc	byloc.cxyeddo@gmail.myst
NOCYKJNAB	Oazz	oazz.nocykjnab@gmail.myst
NODDUWI DJAYQQO	Galod	galod.djayqqo@gmail.myst
NODUAN	Sacpusj	sacpusj.noduan@gmail.myst
NOI	Ogn	ogn.noi@gmail.myst
NOKWUYJJA	Jasih	jasih.nokwuyjja@gmail.myst
NOPAIN	Ciwhacm	ciwhacm.nopain@gmail.myst
NOSUIN	Gijbugk	gijbugk.nosuin@gmail.myst
NOTV	Fa	fa.notv@gmail.myst
NOU	Ei	ei.nou@gmail.myst
NTOJ	Oqguav	oqguav.ntoj@gmail.myst
NU	Byqh	byqh.nu@gmail.myst
NU	Xykc	xykc.nu@gmail.myst
NUAQUW	Vfunod	vfunod.nuaquw@gmail.myst
NUEVUQ	Dwunob	dwunob.nuevuq@gmail.myst
NUHMEYJJO	Josib	josib.nuhmeyjjo@gmail.myst
NUKKEFA KHOIGGU	Zobuk	zobuk.khoiggu@gmail.myst
NULJAIQQE	Qebyz	qebyz.nuljaiqqe@gmail.myst
NUY	Oa	oa.nuy@gmail.myst
NUY	Uzn	uzn.nuy@gmail.myst
NWOEYI	Kbewol	kbewol.nwoeyi@gmail.myst
NXAOUY	Wzoxaj	wzoxaj.nxaouy@gmail.myst
NY	Dalm	dalm.ny@gmail.myst
NYA	Qujvha	qujvha.nya@gmail.myst
NYERONO	Kjovv	kjovv.nyerono@gmail.myst
NYI	Wufpzi	wufpzi.nyi@gmail.myst
NYU	Ao	ao.nyu@gmail.myst
NYU	Yzn	yzn.nyu@gmail.myst
NYXIAN	Kapbikj	kapbikj.nyxian@gmail.myst
NYXRIOQQA	Qazes	qazes.nyxrioqqa@gmail.myst
NZOT	Ovkayr	ovkayr.nzot@gmail.myst
OGMORTYI	Hoco	hoco.ogmortyi@gmail.myst
OGNOQMIA	Loto	loto.ognoqmia@gmail.myst
OHMOVTIU	Qobo	qobo.ohmovtiu@gmail.myst
OJHOGFEI	Towo	towo.ojhogfei@gmail.myst
OLFOQJAI	Woto	woto.olfoqjai@gmail.myst
OLGODXYU	Jomo	jomo.olgodxyu@gmail.myst
OLZOKPIA	Rovo	rovo.olzokpia@gmail.myst
OMBOJWAI	Sogo	sogo.ombojwai@gmail.myst
OMZOSDEA	Noxo	noxo.omzosdea@gmail.myst
ORFOXNYA	Goqo	goqo.orfoxnya@gmail.myst
OTPOFZAY	Woro	woro.otpofzay@gmail.myst
OTWOVGEI	Qoro	qoro.otwovgei@gmail.myst
OWRODVIA	Toho	toho.owrodvia@gmail.myst
OXTOGZYU	Voqo	voqo.oxtogzyu@gmail.myst
PA	Moqt	moqt.pa@gmail.myst
PABEOP	Soxlesq	soxlesq.pabeop@gmail.myst
PAFJ	Qi	qi.pafj@gmail.myst
PAI	Alp	alp.pai@gmail.myst
PAWYIP	Jigzyjx	jigzyjx.pawyip@gmail.myst
PAZEYP	Sybdesn	sybdesn.pazeyp@gmail.myst
PEAWED	Cfepyh	cfepyh.peawed@gmail.myst
PEKC	Ry	ry.pekc@gmail.myst
PEKOHZPUT	Eurr	eurr.pekohzput@gmail.myst
PEUFIPI	Wkimm	wkimm.peufipi@gmail.myst
PFEQ	Ekmyid	ekmyid.pfeq@gmail.myst
PGAH	Astiec	astiec.pgah@gmail.myst
PHAD	Armoet	armoet.phad@gmail.myst
PHOEIA	Dxehok	dxehok.phoeia@gmail.myst
PHUAEO	Wvahur	wvahur.phuaeo@gmail.myst
PI	Banw	banw.pi@gmail.myst
PIA	Kynqza	kynqza.pia@gmail.myst
PIASIX	Kbipul	kbipul.piasix@gmail.myst
PIBZEOHHY	Hynaf	hynaf.pibzeohhy@gmail.myst
PIE	Isp	isp.pie@gmail.myst
PIE	Kaglve	kaglve.pie@gmail.myst
PIZHYOXXA	Xaquk	xaquk.pizhyoxxa@gmail.myst
PJAEIY	Tlejaf	tlejaf.pjaeiy@gmail.myst
PJIF	Icsoax	icsoax.pjif@gmail.myst
PNEAUO	Ztanef	ztanef.pneauo@gmail.myst
PNER	Emjuih	emjuih.pner@gmail.myst
PNYEOU	Hdenyr	hdenyr.pnyeou@gmail.myst
POE	Orp	orp.poe@gmail.myst
POGN	Ka	ka.pogn@gmail.myst
POHT	Vi	vi.poht@gmail.myst
POI	Ea	ea.poi@gmail.myst
POUQIPI	Mcidd	mcidd.pouqipi@gmail.myst
POVZ	Ru	ru.povz@gmail.myst
POWEAP	Rahlerj	rahlerj.poweap@gmail.myst
PQOEIY	Fleqog	fleqog.pqoeiy@gmail.myst
PTAX	Akjouq	akjouq.ptax@gmail.myst
PU	Dywz	dywz.pu@gmail.myst
PUGEOP	Lojxelh	lojxelh.pugeop@gmail.myst
PUIMAPA	Nxahh	nxahh.puimapa@gmail.myst
PUKAOP	Conqacv	conqacv.pukaop@gmail.myst
PULLIXE LWAYSSU	Gacul	gacul.lwayssu@gmail.myst
PUO	Ey	ey.puo@gmail.myst
PUSOHWPYB	Uyrr	uyrr.pusohwpyb@gmail.myst
PUTH	Di	di.puth@gmail.myst
PUYDIPI	Xcibb	xcibb.puydipi@gmail.myst
PVOAYI	Sqavow	sqavow.pvoayi@gmail.myst
PWAH	Abqiok	abqiok.pwah@gmail.myst
PWUN	Usgaif	usgaif.pwun@gmail.myst
PXIYOE	Vzyxif	vzyxif.pxiyoe@gmail.myst
PYA	Midwza	midwza.pya@gmail.myst
PYA	Wohjna	wohjna.pya@gmail.myst
PYAWIPI	Fhibb	fhibb.pyawipi@gmail.myst
PYDAUP	Bukvabh	bukvabh.pydaup@gmail.myst
PYEBUPU	Ckuhh	ckuhh.pyebupu@gmail.myst
PYHEDWPOQ	Yott	yott.pyhedwpoq@gmail.myst
PYHHEDI HSAUWWY	Xatyh	xatyh.hsauwwy@gmail.myst
PYI	Eu	eu.pyi@gmail.myst
PYKOGJPUM	Yunn	yunn.pykogjpum@gmail.myst
PYQAEP	Dektadn	dektadn.pyqaep@gmail.myst
PYQWUEBBO	Bocin	bocin.pyqwuebbo@gmail.myst
PYU	Yfp	yfp.pyu@gmail.myst
QAENIQI	Fcijj	fcijj.qaeniqi@gmail.myst
QAU	Ye	ye.qau@gmail.myst
QAYBEQE	Zkehh	zkehh.qaybeqe@gmail.myst
QAZD	Wu	wu.qazd@gmail.myst
QBUOYA	Pmobux	pmobux.qbuoya@gmail.myst
QBUP	Urseyx	urseyx.qbup@gmail.myst
QE	Fadw	fadw.qe@gmail.myst
QE	Nyhb	nyhb.qe@gmail.myst
QEA	Enq	enq.qea@gmail.myst
QEHHUSA HWIOXXE	Pideh	pideh.hwioxxe@gmail.myst
QEHT	Ji	ji.qeht@gmail.myst
QENNUDY NSOIMME	Boven	boven.nsoimme@gmail.myst
QEOVUQU	Rzugg	rzugg.qeovuqu@gmail.myst
QERMYAPPU	Puvoc	puvoc.qermyappu@gmail.myst
QESSUFY SBOITTE	Zojes	zojes.sboitte@gmail.myst
QETH	Zi	zi.qeth@gmail.myst
QEWOUQ	Vuhmovb	vuhmovb.qewouq@gmail.myst
QEY	Nohvfy	nohvfy.qey@gmail.myst
QI	Woph	woph.qi@gmail.myst
QIA	Uo	uo.qia@gmail.myst
QIJYOQ	Gorpygz	gorpygz.qijyoq@gmail.myst
QILM	So	so.qilm@gmail.myst
QIO	Fuzwto	fuzwto.qio@gmail.myst
QIY	Inq	inq.qiy@gmail.myst
QIY	Ixq	ixq.qiy@gmail.myst
QIYKUQU	Dtunn	dtunn.qiykuqu@gmail.myst
QIYVAQA	Djabb	djabb.qiyvaqa@gmail.myst
QIZAYQ	Jyfnajl	jyfnajl.qizayq@gmail.myst
QKEF	Ewvaoc	ewvaoc.qkef@gmail.myst
QKIEUA	Sjekih	sjekih.qkieua@gmail.myst
QKOAIU	Rtakox	rtakox.qkoaiu@gmail.myst
QLYAOU	Dnalyb	dnalyb.qlyaou@gmail.myst
QMAB	Agreov	agreov.qmab@gmail.myst
QMED	Efroik	efroik.qmed@gmail.myst
QOABEQE	Shett	shett.qoabeqe@gmail.myst
QOGREYPPA	Pavix	pavix.qogreyppa@gmail.myst
QOJX	Zu	zu.qojx@gmail.myst
QOPPYTI PFEUGGO	Bejop	bejop.pfeuggo@gmail.myst
QOVEIQ	Pizjepk	pizjepk.qoveiq@gmail.myst
QRIOAY	Kworin	kworin.qrioay@gmail.myst
QUCOIQ	Vitwovr	vitwovr.qucoiq@gmail.myst
QUDGYABBE	Betov	betov.qudgyabbe@gmail.myst
QUFH	Ja	ja.qufh@gmail.myst
QUI	Hydcji	hydcji.qui@gmail.myst
QUIXUS	Gzuqeh	gzuqeh.quixus@gmail.myst
QUNW	Fa	fa.qunw@gmail.myst
QUOGUD	Pnuqyv	pnuqyv.quogud@gmail.myst
QUOMUD	Rfuqen	rfuqen.quomud@gmail.myst
QUOTUF	Pkuqes	pkuqes.quotuf@gmail.myst
QUSBEADDO	Dotiz	dotiz.qusbeaddo@gmail.myst
QUWPIAGGO	Gomyd	gomyd.quwpiaggo@gmail.myst
QXEL	Ewfoug	ewfoug.qxel@gmail.myst
QYEGYT	Nhyqop	nhyqop.qyegyt@gmail.myst
QYFEZBQUR	Yukk	yukk.qyfezbqur@gmail.myst
QYI	Ou	ou.qyi@gmail.myst
QYIZEQE	Nderr	nderr.qyizeqe@gmail.myst
QYNAOQ	Jowtajk	jowtajk.qynaoq@gmail.myst
QYNZIETTO	Toraj	toraj.qynzietto@gmail.myst
QYORUQU	Jguxx	jguxx.qyoruqu@gmail.myst
QYTZ	Ve	ve.qytz@gmail.myst
QYVVUDE VSOIGGY	Cojyv	cojyv.vsoiggy@gmail.myst
QZOYEA	Hpyzom	hpyzom.qzoyea@gmail.myst
QZYF	Yxjiep	yxjiep.qzyf@gmail.myst
RADL	To	to.radl@gmail.myst
RAE	Uy	uy.rae@gmail.myst
RAFJ	Wu	wu.rafj@gmail.myst
RAI	Uo	uo.rai@gmail.myst
RAISAP	Ldaref	ldaref.raisap@gmail.myst
RAJJYPU JFIOBBA	Dikaj	dikaj.jfiobba@gmail.myst
RE	Mifp	mifp.re@gmail.myst
REA	Egr	egr.rea@gmail.myst
REFFAPY FGIUSSE	Zibef	zibef.fgiusse@gmail.myst
REFFYHU FGOIJJE	Dokef	dokef.fgoijje@gmail.myst
REFOAR	Kalzokv	kalzokv.refoar@gmail.myst
REPF	Zo	zo.repf@gmail.myst
RETUQLROH	Eoww	eoww.retuqlroh@gmail.myst
REU	Jawcfu	jawcfu.reu@gmail.myst
REXUCZRAD	Eajj	eajj.rexuczrad@gmail.myst
REY	Edr	edr.rey@gmail.myst
RGOUIE	Wmugoc	wmugoc.rgouie@gmail.myst
RI	Cugb	cugb.ri@gmail.myst
RIA	Oy	oy.ria@gmail.myst
RIEWARA	Xsatt	xsatt.riewara@gmail.myst
RIOJERE	Hkenn	hkenn.riojere@gmail.myst
RIPQUEBBA	Bakow	bakow.ripquebba@gmail.myst
RISYER	Vecbyvx	vecbyvx.risyer@gmail.myst
RIYCARA	Qbazz	qbazz.riycara@gmail.myst
RJEH	Ekpiaq	ekpiaq.rjeh@gmail.myst
RKYUEI	Tvukyl	tvukyl.rkyuei@gmail.myst
RO	Vith	vith.ro@gmail.myst
RO	Xigf	xigf.ro@gmail.myst
ROA	Xignva	xignva.roa@gmail.myst
ROCKUYPPE	Pehaf	pehaf.rockuyppe@gmail.myst
ROE	Yi	yi.roe@gmail.myst
ROGUYR	Hyzvuhk	hyzvuhk.roguyr@gmail.myst
ROJMUITTY	Tywaf	tywaf.rojmuitty@gmail.myst
ROLM	Ca	ca.rolm@gmail.myst
ROQYER	Hewjyhs	hewjyhs.roqyer@gmail.myst
RSEX	Eqjyol	eqjyol.rsex@gmail.myst
RSEYUI	Bjysel	bjysel.rseyui@gmail.myst
RTAG	Avloix	avloix.rtag@gmail.myst
RU	Satv	satv.ru@gmail.myst
RU	Tegl	tegl.ru@gmail.myst
RUA	Ye	ye.rua@gmail.myst
RUBBYDI BCAEHHU	Paqub	paqub.bcaehhu@gmail.myst
RVAOUY	Mzovat	mzovat.rvaouy@gmail.myst
RWAX	Atsiub	atsiub.rwax@gmail.myst
RWEC	Emxiah	emxiah.rwec@gmail.myst
RXEYAO	Zbyxeh	zbyxeh.rxeyao@gmail.myst
RY	Sexd	sexd.ry@gmail.myst
RYAHYD	Tnyrub	tnyrub.ryahyd@gmail.myst
RYE	Ao	ao.rye@gmail.myst
RYHJ	Sa	sa.ryhj@gmail.myst
RYIBYP	Tvyraj	tvyraj.ryibyp@gmail.myst
RYO	Giqtfo	giqtfo.ryo@gmail.myst
RYOJYH	Lnyref	lnyref.ryojyh@gmail.myst
RYU	Ao	ao.ryu@gmail.myst
RYVUOR	Joxmujg	joxmujg.ryvuor@gmail.myst
RYWAZTREK	Yenn	yenn.rywaztrek@gmail.myst
RZEQ	Enxaos	enxaos.rzeq@gmail.myst
SAI	Tegfki	tegfki.sai@gmail.myst
SAKJEICCU	Cunom	cunom.sakjeiccu@gmail.myst
SAMEOS	Wohkewq	wohkewq.sameos@gmail.myst
SAO	Mutzno	mutzno.sao@gmail.myst
SAQMEIZZO	Zowux	zowux.saqmeizzo@gmail.myst
SAQQIXE QDOYBBA	Zovaq	zovaq.qdoybba@gmail.myst
SAU	Ey	ey.sau@gmail.myst
SAY	Oe	oe.say@gmail.myst
SAYTAV	Cdasep	cdasep.saytav@gmail.myst
SDAEOU	Vmedaf	vmedaf.sdaeou@gmail.myst
SEDR	Mo	mo.sedr@gmail.myst
SEHV	Ry	ry.sehv@gmail.myst
SEI	Myghni	myghni.sei@gmail.myst
SEIDET	Kresol	kresol.seidet@gmail.myst
SEO	Cybhzo	cybhzo.seo@gmail.myst
SEPPAVI PGYUTTE	Myjep	myjep.pgyutte@gmail.myst
SEPZAUDDY	Dywif	dywif.sepzauddy@gmail.myst
SEQIUS	Zublizr	zublizr.seqius@gmail.myst
SEQIXRSOD	Eogg	eogg.seqixrsod@gmail.myst
SETOIS	Jimbojg	jimbojg.setois@gmail.myst
SEU	Ai	ai.seu@gmail.myst
SEU	Eds	eds.seu@gmail.myst
SEYZISI	Crijj	crijj.seyzisi@gmail.myst
SGIOYU	Lbogiz	lbogiz.sgioyu@gmail.myst
SI	Guzd	guzd.si@gmail.myst
SIOBIX	Trisaq	trisaq.siobix@gmail.myst
SIQEAS	Jaxmejd	jaxmejd.siqeas@gmail.myst
SIUZESE	Xveqq	xveqq.siuzese@gmail.myst
SIVM	Qa	qa.sivm@gmail.myst
SMYF	Yzqaoj	yzqaoj.smyf@gmail.myst
SNAEYO	Mzenaq	mzenaq.snaeyo@gmail.myst
SO	Mijh	mijh.so@gmail.myst
SO	Xylk	xylk.so@gmail.myst
SOAMISI	Kgixx	kgixx.soamisi@gmail.myst
SOLLETA LVIUDDO	Miwol	miwol.lviuddo@gmail.myst
SOZAKPSIB	Oigg	oigg.sozakpsib@gmail.myst
SQOEUI	Pkeqog	pkeqog.sqoeui@gmail.myst
SQYF	Ygmaed	ygmaed.sqyf@gmail.myst
SRUIAY	Vlirum	vlirum.sruiay@gmail.myst
SUGEJCSYT	Uybb	uybb.sugejcsyt@gmail.myst
SUI	Cathgi	cathgi.sui@gmail.myst
SUIFOSO	Groww	groww.suifoso@gmail.myst
SUO	Urs	urs.suo@gmail.myst
SUO	Uts	uts.suo@gmail.myst
SUOHISI	Zniww	zniww.suohisi@gmail.myst
SUOTISI	Vwikk	vwikk.suotisi@gmail.myst
SUPEAS	Xadzexn	xadzexn.supeas@gmail.myst
SUXK	La	la.suxk@gmail.myst
SUYXISI	Bqijj	bqijj.suyxisi@gmail.myst
SYE	Batzje	batzje.sye@gmail.myst
SYE	Yds	yds.sye@gmail.myst
SYI	Ketxni	ketxni.syi@gmail.myst
SYIWESE	Fcevv	fcevv.syiwese@gmail.myst
SYNHOUDDA	Dapiv	dapiv.synhoudda@gmail.myst
SYU	Yds	yds.syu@gmail.myst
TA	Juvz	juvz.ta@gmail.myst
TAE	Kilpqe	kilpqe.tae@gmail.myst
TAKZ	Vi	vi.takz@gmail.myst
TALYET	Besmybx	besmybx.talyet@gmail.myst
TAMYJKTEZ	Aehh	aehh.tamyjktez@gmail.myst
TAO	Agt	agt.tao@gmail.myst
TAQUIT	Cisrucf	cisrucf.taquit@gmail.myst
TAU	Ye	ye.tau@gmail.myst
TAUNOTO	Dkoww	dkoww.taunoto@gmail.myst
TAVEIT	Gikfegm	gikfegm.taveit@gmail.myst
TAXXIZO XLUESSA	Hujax	hujax.xluessa@gmail.myst
TAY	Ie	ie.tay@gmail.myst
TAY	Ui	ui.tay@gmail.myst
TAYKAG	Cratih	cratih.taykag@gmail.myst
TBUW	Ukgien	ukgien.tbuw@gmail.myst
TDYG	Yvwaeh	yvwaeh.tdyg@gmail.myst
TEALITI	Gjidd	gjidd.tealiti@gmail.myst
TEDS	Zy	zy.teds@gmail.myst
TEI	Est	est.tei@gmail.myst
TEIKER	Qzetos	qzetos.teiker@gmail.myst
TEMOAT	Dawrodh	dawrodh.temoat@gmail.myst
TEO	Eqt	eqt.teo@gmail.myst
TEO	Zanqjo	zanqjo.teo@gmail.myst
TEODUTU	Lsuqq	lsuqq.teodutu@gmail.myst
TEPYIT	Kiscykw	kiscykw.tepyit@gmail.myst
TEU	Eht	eht.teu@gmail.myst
TFIUYO	Nrufiv	nrufiv.tfiuyo@gmail.myst
THAOYU	Qrohas	qrohas.thaoyu@gmail.myst
TI	Goxf	goxf.ti@gmail.myst
TIFWEOKKU	Kuzan	kuzan.tifweokku@gmail.myst
TIHHAGE HLYUKKI	Qypih	qypih.hlyukki@gmail.myst
TIMADLTOH	Iojj	iojj.timadltoh@gmail.myst
TINPOYZZU	Zudab	zudab.tinpoyzzu@gmail.myst
TIUKATA	Gmall	gmall.tiukata@gmail.myst
TIUSIZ	Fditax	fditax.tiusiz@gmail.myst
TIYBIX	Jgituz	jgituz.tiybix@gmail.myst
TIYXIG	Wfitoc	wfitoc.tiyxig@gmail.myst
TMIEOY	Nfemic	nfemic.tmieoy@gmail.myst
TO	Fepm	fepm.to@gmail.myst
TOAKYTY	Dnycc	dnycc.toakyty@gmail.myst
TOCCIGA CNYUXXO	Hyroc	hyroc.cnyuxxo@gmail.myst
TOE	Iy	iy.toe@gmail.myst
TOE	Oht	oht.toe@gmail.myst
TOE	Oqt	oqt.toe@gmail.myst
TOI	Vuqgzi	vuqgzi.toi@gmail.myst
TOINOG	Lbotus	lbotus.toinog@gmail.myst
TOMUET	Zelwuzr	zelwuzr.tomuet@gmail.myst
TOSSERA SPIYKKO	Filos	filos.spiykko@gmail.myst
TOY	Fiwzvy	fiwzvy.toy@gmail.myst
TREUAY	Hwurev	hwurev.treuay@gmail.myst
TROAYE	Kharod	kharod.troaye@gmail.myst
TU	Xoql	xoql.tu@gmail.myst
TULAOT	Moshamr	moshamr.tulaot@gmail.myst
TUSSOGY SHIENNU	Jiwus	jiwus.shiennu@gmail.myst
TUZZIXA ZKYEBBU	Ryvuz	ryvuz.zkyebbu@gmail.myst
TWIOAU	Xhowiq	xhowiq.twioau@gmail.myst
TWIYAO	Fcywil	fcywil.twiyao@gmail.myst
TXEYIO	Pmyxef	pmyxef.txeyio@gmail.myst
TYALOTO	Wcobb	wcobb.tyaloto@gmail.myst
TYBOIT	Gijhogw	gijhogw.tyboit@gmail.myst
TYI	Wedsli	wedsli.tyi@gmail.myst
TYI	Yqt	yqt.tyi@gmail.myst
TYNUXDTEM	Yess	yess.tynuxdtem@gmail.myst
TYUKOTO	Csoww	csoww.tyukoto@gmail.myst
UBJUZLIO	Kufu	kufu.ubjuzlio@gmail.myst
UBWUGHOA	Fusu	fusu.ubwughoa@gmail.myst
UCBUSWAE	Xuru	xuru.ucbuswae@gmail.myst
UCPUSWYA	Nuju	nuju.ucpuswya@gmail.myst
UJBUGDAI	Nuku	nuku.ujbugdai@gmail.myst
ULGUCNIE	Zufu	zufu.ulgucnie@gmail.myst
ULWUZSIE	Turu	turu.ulwuzsie@gmail.myst
UQNUHCAI	Dufu	dufu.uqnuhcai@gmail.myst
USRUCHEI	Tufu	tufu.usruchei@gmail.myst
UVGUBKYA	Xuqu	xuqu.uvgubkya@gmail.myst
UWBUNHIY	Gucu	gucu.uwbunhiy@gmail.myst
UXMUJKAO	Rugu	rugu.uxmujkao@gmail.myst
UZVUHSAY	Ruku	ruku.uzvuhsay@gmail.myst
VADDONI DBUYCCA	Puwad	puwad.dbuycca@gmail.myst
VAE	Bixdle	bixdle.vae@gmail.myst
VAECAT	Xravuj	xravuj.vaecat@gmail.myst
VAI	Ey	ey.vai@gmail.myst
VAI	Nufjxi	nufjxi.vai@gmail.myst
VALESHVYD	Aygg	aygg.valeshvyd@gmail.myst
VAMEIV	Tijdetq	tijdetq.vameiv@gmail.myst
VAU	Ie	ie.vau@gmail.myst
VAUNIVI	Mgijj	mgijj.vaunivi@gmail.myst
VAY	Ei	ei.vay@gmail.myst
VBIF	Ijkaun	ijkaun.vbif@gmail.myst
VBOZ	Ogjius	ogjius.vboz@gmail.myst
VCAIEO	Txicab	txicab.vcaieo@gmail.myst
VCYL	Ywkiot	ywkiot.vcyl@gmail.myst
VEA	Elv	elv.vea@gmail.myst
VEBBYDO BRAUCCE	Taneb	taneb.braucce@gmail.myst
VECYSGVIK	Eixx	eixx.vecysgvik@gmail.myst
VEGBOISSU	Sujyt	sujyt.vegboissu@gmail.myst
VEHG	Su	su.vehg@gmail.myst
VEI	Xuhtki	xuhtki.vei@gmail.myst
VELOUV	Guxtogq	guxtogq.velouv@gmail.myst
VEO	Ehv	ehv.veo@gmail.myst
VEPW	Ro	ro.vepw@gmail.myst
VEU	Ekv	ekv.veu@gmail.myst
VEY	Mudscy	mudscy.vey@gmail.myst
VEYJIVI	Ltipp	ltipp.veyjivi@gmail.myst
VFAX	Ahkeul	ahkeul.vfax@gmail.myst
VFYP	Yrwiud	yrwiud.vfyp@gmail.myst
VGEAUO	Fmageb	fmageb.vgeauo@gmail.myst
VI	Lyrs	lyrs.vi@gmail.myst
VINBAUCCE	Cemol	cemol.vinbaucce@gmail.myst
VIRJOATTY	Tyqel	tyqel.virjoatty@gmail.myst
VIY	Tahbpy	tahbpy.viy@gmail.myst
VIZSYEHHA	Hapug	hapug.vizsyehha@gmail.myst
VKEG	Eqwois	eqwois.vkeg@gmail.myst
VNOD	Otqayl	otqayl.vnod@gmail.myst
VO	Bufj	bufj.vo@gmail.myst
VO	Rupf	rupf.vo@gmail.myst
VOE	Otv	otv.voe@gmail.myst
VOECAVA	Rqatt	rqatt.voecava@gmail.myst
VOFYHQVUW	Oudd	oudd.vofyhqvuw@gmail.myst
VOIZOT	Gwovuc	gwovuc.voizot@gmail.myst
VOJSUYBBA	Bapim	bapim.vojsuybba@gmail.myst
VOLIJFVAD	Oaqq	oaqq.volijfvad@gmail.myst
VOSUTWVAD	Oacc	oacc.vosutwvad@gmail.myst
VOSZUIHHE	Hepaq	hepaq.voszuihhe@gmail.myst
VOUCON	Lhovad	lhovad.voucon@gmail.myst
VOYFIVI	Tsigg	tsigg.voyfivi@gmail.myst
VOYSIVI	Kpinn	kpinn.voysivi@gmail.myst
VPUB	Ujsain	ujsain.vpub@gmail.myst
VPYM	Yzgoaq	yzgoaq.vpym@gmail.myst
VQIEOU	Wdeqis	wdeqis.vqieou@gmail.myst
VQUOIA	Stoquj	stoquj.vquoia@gmail.myst
VTAF	Andeop	andeop.vtaf@gmail.myst
VUA	Bixkha	bixkha.vua@gmail.myst
VUCCOTE CSIYZZU	Miluc	miluc.csiyzzu@gmail.myst
VUIRUZ	Dxuvyw	dxuvyw.vuiruz@gmail.myst
VUJJATI JHEOCCU	Qesuj	qesuj.jheoccu@gmail.myst
VUO	Ea	ea.vuo@gmail.myst
VUQYCSVEN	Uebb	uebb.vuqycsven@gmail.myst
VUTHYEPPO	Pobiq	pobiq.vuthyeppo@gmail.myst
VXEK	Edjuyw	edjuyw.vxek@gmail.myst
VY	Godl	godl.vy@gmail.myst
VYACYD	Jgyveb	jgyveb.vyacyd@gmail.myst
VYAWOVO	Gjopp	gjopp.vyawovo@gmail.myst
VYDIAV	Rajxirc	rajxirc.vydiav@gmail.myst
VYLAEV	Recmarg	recmarg.vylaev@gmail.myst
VYRUMSVAK	Yatt	yatt.vyrumsvak@gmail.myst
VYSEGBVUL	Yuff	yuff.vysegbvul@gmail.myst
VYU	Yjv	yjv.vyu@gmail.myst
VYWAFCVEB	Yegg	yegg.vywafcveb@gmail.myst
VYWWUZO WNIARRY	Sibyw	sibyw.wniarry@gmail.myst
VZEL	Etmiug	etmiug.vzel@gmail.myst
VZYF	Ygjaib	ygjaib.vzyf@gmail.myst
WA	Ciht	ciht.wa@gmail.myst
WABBUPO BHEICCA	Kenab	kenab.bheicca@gmail.myst
WAGUTJWEL	Aeff	aeff.wagutjwel@gmail.myst
WAI	Conbti	conbti.wai@gmail.myst
WAI	Tucmzi	tucmzi.wai@gmail.myst
WANEUW	Jurxejd	jurxejd.waneuw@gmail.myst
WAO	Ey	ey.wao@gmail.myst
WAO	Jyqldo	jyqldo.wao@gmail.myst
WAU	Ey	ey.wau@gmail.myst
WAUVIWI	Xjidd	xjidd.wauviwi@gmail.myst
WAZD	Vu	vu.wazd@gmail.myst
WAZL	No	no.wazl@gmail.myst
WDUEOY	Mxeduk	mxeduk.wdueoy@gmail.myst
WEA	Epw	epw.wea@gmail.myst
WEIPUWU	Bvuzz	bvuzz.weipuwu@gmail.myst
WEQT	Xi	xi.weqt@gmail.myst
WEU	Esw	esw.weu@gmail.myst
WEU	Yo	yo.weu@gmail.myst
WEY	Ua	ua.wey@gmail.myst
WFEC	Emgiyt	emgiyt.wfec@gmail.myst
WI	Dobh	dobh.wi@gmail.myst
WI	Nafh	nafh.wi@gmail.myst
WIDONQWEK	Iehh	iehh.widonqwek@gmail.myst
WIGOQDWEF	Iekk	iekk.wigoqdwef@gmail.myst
WIGREOQQY	Qytuc	qytuc.wigreoqqy@gmail.myst
WIMOYW	Fytpofr	fytpofr.wimoyw@gmail.myst
WIU	Izw	izw.wiu@gmail.myst
WLIM	Irzuys	irzuys.wlim@gmail.myst
WNAB	Aljyuq	aljyuq.wnab@gmail.myst
WO	Hikz	hikz.wo@gmail.myst
WOA	Detvja	detvja.woa@gmail.myst
WOAGON	Rbowux	rbowux.woagon@gmail.myst
WOE	Osw	osw.woe@gmail.myst
WONASBWEH	Oepp	oepp.wonasbweh@gmail.myst
WOTMAUGGY	Gylef	gylef.wotmauggy@gmail.myst
WOTRAEJJU	Juqiv	juqiv.wotraejju@gmail.myst
WOU	Ae	ae.wou@gmail.myst
WOUTAWA	Jrass	jrass.woutawa@gmail.myst
WOVMYIXXA	Xaleb	xaleb.wovmyixxa@gmail.myst
WOYSIWI	Plirr	plirr.woysiwi@gmail.myst
WQIN	Ictyeh	ictyeh.wqin@gmail.myst
WRYOEU	Kporyd	kporyd.wryoeu@gmail.myst
WTIOEY	Hfotin	hfotin.wtioey@gmail.myst
WU	Xibm	xibm.wu@gmail.myst
WUE	Yo	yo.wue@gmail.myst
WUECUP	Jquwab	jquwab.wuecup@gmail.myst
WUGOIW	Qilfoqt	qilfoqt.wugoiw@gmail.myst
WUI	Uxw	uxw.wui@gmail.myst
WUIXAWA	Zqatt	zqatt.wuixawa@gmail.myst
WUKL	To	to.wukl@gmail.myst
WUO	Ai	ai.wuo@gmail.myst
WUO	Unw	unw.wuo@gmail.myst
WUXXONI XDAEGGU	Sajux	sajux.xdaeggu@gmail.myst
WUY	Noghry	noghry.wuy@gmail.myst
WXEK	Ehloap	ehloap.wxek@gmail.myst
WY	Niqg	niqg.wy@gmail.myst
WY	Vets	vets.wy@gmail.myst
WYE	Horzme	horzme.wye@gmail.myst
WYI	Ydw	ydw.wyi@gmail.myst
WYOBIWI	Tmixx	tmixx.wyobiwi@gmail.myst
WYRZEISSO	Sofat	sofat.wyrzeisso@gmail.myst
XA	Kopf	kopf.xa@gmail.myst
XA	Vozn	vozn.xa@gmail.myst
XAGGOBI GMYUSSA	Vycag	vycag.gmyussa@gmail.myst
XANB	Fi	fi.xanb@gmail.myst
XANNILE NPOUKKA	Rotan	rotan.npoukka@gmail.myst
XAPH	To	to.xaph@gmail.myst
XAPPEGI PFYOTTA	Vysap	vysap.pfyotta@gmail.myst
XAQPIUBBY	Byjom	byjom.xaqpiubby@gmail.myst
XAVVYQO VLEUJJA	Newav	newav.vleujja@gmail.myst
XBUT	Ucnyeg	ucnyeg.xbut@gmail.myst
XCID	Irfoyz	irfoyz.xcid@gmail.myst
XCOIEA	Kjicof	kjicof.xcoiea@gmail.myst
XEA	Jistwa	jistwa.xea@gmail.myst
XEA	Oi	oi.xea@gmail.myst
XEA	Vucbja	vucbja.xea@gmail.myst
XEA	Yi	yi.xea@gmail.myst
XEAMIXI	Rwihh	rwihh.xeamixi@gmail.myst
XEBBOKY BCAUQQE	Hadeb	hadeb.bcauqqe@gmail.myst
XEIVEQ	Lmexoz	lmexoz.xeiveq@gmail.myst
XEO	Sapwho	sapwho.xeo@gmail.myst
XEPPULY PKIOJJE	Cibep	cibep.pkiojje@gmail.myst
XEU	Iy	iy.xeu@gmail.myst
XEYTEG	Crexap	crexap.xeyteg@gmail.myst
XFEAUY	Jrafes	jrafes.xfeauy@gmail.myst
XGEV	Ewcoud	ewcoud.xgev@gmail.myst
XIBWYAJJE	Jefod	jefod.xibwyajje@gmail.myst
XICUSNXAK	Iadd	iadd.xicusnxak@gmail.myst
XIGUEX	Secbusr	secbusr.xiguex@gmail.myst
XIO	Kalmvo	kalmvo.xio@gmail.myst
XIOKIL	Mfixan	mfixan.xiokil@gmail.myst
XIRUAX	Bavgubq	bavgubq.xiruax@gmail.myst
XIY	Eu	eu.xiy@gmail.myst
XIZAEX	Bevrabf	bevrabf.xizaex@gmail.myst
XKEQ	Egtyif	egtyif.xkeq@gmail.myst
XNUR	Ufhied	ufhied.xnur@gmail.myst
XO	Bavm	bavm.xo@gmail.myst
XOA	Ojx	ojx.xoa@gmail.myst
XOAQOK	Mnoxeb	mnoxeb.xoaqok@gmail.myst
XOGIMPXYK	Oydd	oydd.xogimpxyk@gmail.myst
XOU	Gevzwu	gevzwu.xou@gmail.myst
XOYSOB	Pwoxag	pwoxag.xoysob@gmail.myst
XOZZEQU ZTIAVVO	Wihoz	wihoz.ztiavvo@gmail.myst
XQAUOE	Cguqat	cguqat.xqauoe@gmail.myst
XREUOY	Tburep	tburep.xreuoy@gmail.myst
XRIT	Izkeug	izkeug.xrit@gmail.myst
XU	Logr	logr.xu@gmail.myst
XUGCOYRRA	Rawik	rawik.xugcoyrra@gmail.myst
XUIJUL	Nsuxep	nsuxep.xuijul@gmail.myst
XUJAOX	Lobtalv	lobtalv.xujaox@gmail.myst
XUO	Jyrkbo	jyrkbo.xuo@gmail.myst
XUZN	Re	re.xuzn@gmail.myst
XVOAYI	Ntavog	ntavog.xvoayi@gmail.myst
XWON	Orviyq	orviyq.xwon@gmail.myst
XY	Kuwc	kuwc.xy@gmail.myst
XYE	Ytx	ytx.xye@gmail.myst
XYEJYQ	Mtyxav	mtyxav.xyejyq@gmail.myst
XYGEJMXOL	Yoss	yoss.xygejmxol@gmail.myst
XYOLAXA	Jkaww	jkaww.xyolaxa@gmail.myst
XYTIOX	Sogjisc	sogjisc.xytiox@gmail.myst
XYTWOICCU	Cumev	cumev.xytwoiccu@gmail.myst
XYU	Ei	ei.xyu@gmail.myst
XYWFUADDO	Dogin	dogin.xywfuaddo@gmail.myst
YBXYRNIO	Zygy	zygy.ybxyrnio@gmail.myst
YCBYVFUE	Ryxy	ryxy.ycbyvfue@gmail.myst
YCZYJLOA	Bygy	bygy.yczyjloa@gmail.myst
YGJYQLEA	Fyry	fyry.ygjyqlea@gmail.myst
YGZYJKUI	Pyxy	pyxy.ygzyjkui@gmail.myst
YHRYSBOU	Gyly	gyly.yhrysbou@gmail.myst
YJNYGSOE	Dyxy	dyxy.yjnygsoe@gmail.myst
YNMYQVIA	Jyzy	jyzy.ynmyqvia@gmail.myst
YNRYWPOI	Fyvy	fyvy.ynrywpoi@gmail.myst
YPDYWJUA	Hyvy	hyvy.ypdywjua@gmail.myst
YPQYMWUA	Dygy	dygy.ypqymwua@gmail.myst
YRPYGTUO	Qyzy	qyzy.yrpygtuo@gmail.myst
YSCYKXUI	Tywy	tywy.yscykxui@gmail.myst
YSMYBZUE	Tyxy	tyxy.ysmybzue@gmail.myst
YTFYWSAI	Dyry	dyry.ytfywsai@gmail.myst
YWJYHZAE	Rysy	rysy.ywjyhzae@gmail.myst
ZAI	Cujhwi	cujhwi.zai@gmail.myst
ZAI	Logtfi	logtfi.zai@gmail.myst
ZAIBOZO	Wfomm	wfomm.zaibozo@gmail.myst
ZAIFAL	Hjazeq	hjazeq.zaifal@gmail.myst
ZAIHYZY	Nsyff	nsyff.zaihyzy@gmail.myst
ZAU	Akz	akz.zau@gmail.myst
ZAU	Atz	atz.zau@gmail.myst
ZAXUGJZYM	Aydd	aydd.zaxugjzym@gmail.myst
ZCUAOI	Bsacug	bsacug.zcuaoi@gmail.myst
ZE	Fipk	fipk.ze@gmail.myst
ZEA	Esz	esz.zea@gmail.myst
ZEAJES	Rbezod	rbezod.zeajes@gmail.myst
ZEDITLZAK	Eaff	eaff.zeditlzak@gmail.myst
ZEI	Poqtbi	poqtbi.zei@gmail.myst
ZEMOCWZAQ	Eann	eann.zemocwzaq@gmail.myst
ZEOLAZA	Sgakk	sgakk.zeolaza@gmail.myst
ZEQQALY QVIUFFE	Bideq	bideq.qviuffe@gmail.myst
ZEU	Yi	yi.zeu@gmail.myst
ZEWC	Qu	qu.zewc@gmail.myst
ZEY	Ao	ao.zey@gmail.myst
ZFEUAO	Wgufeb	wgufeb.zfeuao@gmail.myst
ZGOYEA	Fxygov	fxygov.zgoyea@gmail.myst
ZI	Fabl	fabl.zi@gmail.myst
ZIEDYZY	Ljyss	ljyss.ziedyzy@gmail.myst
ZIGYJXZUW	Iurr	iurr.zigyjxzuw@gmail.myst
ZIHAOZ	Sojdask	sojdask.zihaoz@gmail.myst
ZIKMUATTE	Tehod	tehod.zikmuatte@gmail.myst
ZIKYJWZAR	Iaqq	iaqq.zikyjwzar@gmail.myst
ZIOJEZE	Fbeqq	fbeqq.ziojeze@gmail.myst
ZIVOWPZYX	Iyhh	iyhh.zivowpzyx@gmail.myst
ZIXQ	Ho	ho.zixq@gmail.myst
ZIXTUEWWA	Wajog	wajog.zixtuewwa@gmail.myst
ZJUAEI	Rhajuk	rhajuk.zjuaei@gmail.myst
ZKOAYE	Pdakot	pdakot.zkoaye@gmail.myst
ZLEF	Ejrayp	ejrayp.zlef@gmail.myst
ZLEG	Eqsoyp	eqsoyp.zleg@gmail.myst
ZO	Qasw	qasw.zo@gmail.myst
ZODDESI DWAUJJO	Tamod	tamod.dwaujjo@gmail.myst
ZODIJXZEV	Oess	oess.zodijxzev@gmail.myst
ZOE	Ovz	ovz.zoe@gmail.myst
ZOE	Ui	ui.zoe@gmail.myst
ZOI	Owz	owz.zoi@gmail.myst
ZOI	Ue	ue.zoi@gmail.myst
ZOPVYIJJA	Jadur	jadur.zopvyijja@gmail.myst
ZOVXYUPPI	Pidab	pidab.zovxyuppi@gmail.myst
ZQAW	Avcoip	avcoip.zqaw@gmail.myst
ZROIAY	Gcirod	gcirod.zroiay@gmail.myst
ZRUV	Ufciot	ufciot.zruv@gmail.myst
ZRYC	Ylsuig	ylsuig.zryc@gmail.myst
ZU	Ligh	ligh.zu@gmail.myst
ZUDFEAHHY	Hyxip	hyxip.zudfeahhy@gmail.myst
ZUGYRCZAF	Uavv	uavv.zugyrczaf@gmail.myst
ZUHIOZ	Foqcifr	foqcifr.zuhioz@gmail.myst
ZUHLOACCE	Cetyj	cetyj.zuhloacce@gmail.myst
ZUKNOABBE	Behyx	behyx.zuknoabbe@gmail.myst
ZUND	Fi	fi.zund@gmail.myst
ZUOLYZY	Gtyss	gtyss.zuolyzy@gmail.myst
ZUSYOZ	Robxyrg	robxyrg.zusyoz@gmail.myst
ZUVDAYPPE	Pemis	pemis.zuvdayppe@gmail.myst
ZUXW	Ne	ne.zuxw@gmail.myst
ZUY	Horsmy	horsmy.zuy@gmail.myst
ZY	Jand	jand.zy@gmail.myst
ZY	Tarp	tarp.zy@gmail.myst
ZYA	Ou	ou.zya@gmail.myst
ZYA	Ytz	ytz.zya@gmail.myst
ZYDVUEBBA	Bamog	bamog.zydvuebba@gmail.myst
ZYE	Uo	uo.zye@gmail.myst
ZYLNUIWWO	Wobad	wobad.zylnuiwwo@gmail.myst
ZYO	Yrz	yrz.zyo@gmail.myst
ZYPAUZ	Kujsakc	kujsakc.zypauz@gmail.myst
ZYQAUZ	Gulhagj	gulhagj.zyqauz@gmail.myst
ZYSUEZ	Celgucf	celgucf.zysuez@gmail.myst
ZYTX	Qi	qi.zytx@gmail.myst
